MMMMMMMMMMMMMMMMMMMM,
MS................SM,
M..MMMMMMMMMMMMMM..M,
M..MPPPMFGHKMPPPM..M,
MP.M............M..M,
M..M..P.........M..M,
M..M............M..M,
M..M.PPPPPPPPPP.M..M,
M..M.P...M....P.M..M,
M....P........P....M,
M....P.....M..P....M,
M..M.P........P.M..M,
M..M.P........P.M..M,
M..M.P........P.M..M,
M..M.P........P.M..M,
M..M.P...J..MMM.M..M,
M..M.PPPPPPPPPP.M..M,
M..MMMMMMMMMMMMMM..M,
MS................SM,
MMMMMMMMMMMMMMMMMMMM