MMMMMMMMMMMMMMMMMMMM
MSSS...............M
M..MMMMMMMMMMMMMM..M
M..M...MFGHKM...M..M
MP.M............M..M
M..M..P.........M..M
M..M............M..M
M..M.P..........M..M
M..M.P...M......M..M
M....P.............M
M....P.....M.......M
M..M.P..........M..M
M..M.P..........M..M
M..M.P..........M..M
M..M.P..........M..M
M..M.P......MMM.M..M
M..M.P..........M..M
M..MMMMMMMMMMMMMM..M
MJ.................M
MMMMMMMMMMMMMMMMMMMM