MMMMMMMMMMMMMMMMMMMM,
MS...R.....R......SM,
M..MMMMMMMMMMMMMM..M,
M..MPPPMFGHKMPPPM..M,
MP.M...............M,
M..M..P....R.......M,
M..M...............M,
M..M.PPPPPPPPPP....M,
M..M.P...M....P....M,
M....P........P....M,
M.R..P.....M..P....M,
M..M.P.R..R...P....M,
M..M.P........P....M,
M..M.P.....R..P....M,
M..M.P........P....M,
M..M.P...J..MMM....M,
M..M.PPPPPPPPPP....M,
M..MMMMMMMMMMMMMM..M,
MS................SM,
MMMMMMMMMMMMMMMMMMMM,